12,13,
1,1,1,1,1,1,1,1,1,-1,-1,1,
1,0,0,0,0,0,0,0,0,0,0,1,
1,0,0,0,0,0,0,0,0,0,0,1,
1,0,0,0,0,0,0,0,0,0,0,1,
1,0,0,1,1,-2,-2,1,1,0,0,1,
1,0,0,1,3,0,0,4,1,0,0,1,
1,0,0,1,5,6,7,8,1,0,0,1,
1,0,0,1,5,9,10,11,1,0,0,1,
1,0,0,1,12,2,2,13,1,0,0,1,
1,0,0,1,12,2,2,13,1,0,0,1,
1,0,0,1,1,1,1,1,1,0,0,1,
1,0,0,0,0,0,0,0,0,0,0,1,
1,1,1,1,1,1,1,1,1,1,1,1,