12,13,
1,1,1,1,1,1,1,1,1,-1,-1,1,
1,0,0,0,0,0,0,0,0,0,0,1,
1,0,0,0,0,0,0,0,0,0,0,1,
1,0,0,0,0,0,0,0,0,0,0,1,
1,0,0,1,1,-2,-2,1,1,0,0,1,
1,0,0,1,3,0,0,-3,1,0,0,1,
1,0,0,1,-3,4,-3,5,1,0,0,1,
1,0,0,1,6,-3,7,-3,1,0,0,1,
1,0,0,1,-3,2,2,8,1,0,0,1,
1,0,0,1,9,2,2,-3,1,0,0,1,
1,0,0,1,1,1,1,1,1,0,0,1,
1,0,0,0,0,0,0,0,0,0,0,1,
1,1,1,1,1,1,1,1,1,1,1,1,